Name	IATA	ICAO
Private flight	-	N/A
Unknown	-	N/A
ELK Airways	--	ELK
Tom\\'s & co airliners	&T	T&O
Wilderness Air	";;"	\N
Tyrolean Airways	\N	TYR
Whitaker Air	^^	\N
U.S. Air	-+	--+
Bobb Air Freight	1	\N
Blue Air	0B	JOR
Darwin Airline	0D	DWT
Copenhagen Express	0X	CX0
TUIfly (X3)	11	\N
12 North	12	N12
Eastern Atlantic Virtual Airlines	13	EAV
Abacus International	1B	
OneChina	1C	1CH
CB Airways UK ( Interliging Flights )	1F	CIF
NetJets	1I	EJA
Novair	1I	NVR
1Time Airline	1T	RNX
Air Salone	20	RNE
Euro Jet	24	\N
Deutsche Bahn	2A	
Aerocondor	2B	ARD
Aero VIP (2D)	2D	\N
Frontier Flying Service	2F	FTA
Star Peru (2I)	2I	\N
Air Burkina	2J	VBW
Aerolineas Galapagos (Aerogal)	2K	GLG
Helvetic Airways	2L	OAW
Moldavian Airlines	2M	MDV
NextJet	2N	NTJ
Air Salone	2O	
Air Philippines	2P	GAP
Air Cargo Carriers	2Q	SNC
Haiti Ambassador Airlines	2T	HAM
Air Guinee Express	2U	GIP
Welcome Air	2W	WLC
Regionalia Uruguay	2X	2K2
JobAir	3B	\N
Air Choice One	3E	\N
Fly Colombia ( Interliging Flights )	3F	3FF
Atlant-Soyuz Airlines	3G	AYZ
Air Comet Chile	3I	\N
Jetstar Asia Airways	3K	JSA
Intersky	3L	ISK
Air Arabia Maroc	3O	\N
Tiara Air	3P	TNM
Yunnan Airlines	3Q	CYH
Moskovia Airlines	3R	GAI
Air Antilles Express	3S	\N
Turan Air	3T	URN
Sichuan Airlines	3U	CSC
Malawian Airlines	3W	\N
Air Kiribati	4A	AKL
Aires	4C	ARE
Air Sinai	4D	ASD
Gazpromavia	4G	GZP
United Airways	4H	UBD
Askari Aviation	4K	AAS
Euroline	4L	MJX
LAN Argentina	4M	DSM
Air North Charter - Canada	4N	ANT
Interjet (ABC Aerolineas)	4O	\N
Business Aviation	4P	\N
Safi Airlines	4Q	\N
Hamburg International	4R	HHI
Belair Airlines	4T	BHP
Germanwings	4U	GWI
Red Jet Mexico	4X	\N
Airlink (SAA)	4Z	\N
CAL Cargo Air Lines	5C	ICL
Aerolitoral	5D	SLI
DonbassAero	5D	UDC
SGA Airlines	5E	\N
Skyservice Airlines	5G	SSV
Fly540	5H	FFV
Cebu Pacific	5J	CEB
Hi Fly (5K)	5K	\N
Aerosur	5L	RSU
Sibaviatrans	5M	SIB
Aeroflot-Nord	5N	AUL
Pal airlines	5P	\N
BQB Lineas Aereas	5Q	\N
Canadian North	5T	MPE
Astraeus	5W	AEU
Atlas Air	5Y	GTI
VivaColombia	5Z	VVC
Royal European Airlines	69	\N
Consorcio Aviaxsa	6A	CHP
TUIfly Nordic	6B	BLX
Vuela Cuba	6C	6CC
Pelita	6D	\N
IndiGo Airlines	6E	IGO
MAT Airways	6F	MKD
Air Wales	6G	AWW
Israir	6H	ISR
Fly 6ix	6I	\N
Skynet Asia Airways	6J	SNJ
Asian Spirit	6K	RIT
Gryphon Airlines	6P	\N
Alrosa Mirny Air Enterprise	6R	DRU
Air Mandalay	6T	\N
Air Cargo Germany	6U	\N
Saratov Aviation Division	6W	SOV
SmartLynx Airlines	6Y	\N
Southjet	76	SJS
Southjet connect	77	ZCS
Southjet cargo	78	XAN
Krasnojarsky Airlines	7B	KJC
Jeju Air	7C	JJA
Aeroline GmbH	7E	AWU
First Air	7F	FAB
Star Flyer	7G	SFJ
Era Alaska	7H	ERR
Insel Air (7I/INC) (Priv)	7I	\N
Tajik Air	7J	\N
Kogalymavia Air Company	7K	KGL
Sun D'Or	7L	ERO
Mongolian International Air Lines 	7M	ZTF
All Colombia	7O	7KK
Metro Batavia	7P	BTV
Pan Am World Airways Dominicana	7Q	\N
Air Glaciers	7T	AGV
Wayraper	7W	
Med Airways	7Y	\N
Halcyonair	7Z	\N
All Australia	88	8K8
Atlas Blue	8A	BMM
BusinessAir	8B	BCC
Astair	8D	
Bering Air	8E	BRG
STP Airways	8F	STP
Heli France	8H	HFR
Myway Airlines	8I	
Jet4You	8J	JFU
Voestar	8K	K88
Cargo Plus Aviation	8L	CGP
Myanmar Airways International	8M	MMM
Maxair	8M	MXL
Barents AirLink	8N	NKF
West Coast Air	8O	
Pacific Coastal Airline	8P	PCO
Maldivian Air Taxi	8Q	\N
Onur Air	8Q	OHY
TRIP Linhas A	8R	TIB
Air Tindi	8T	
Afriqiyah Airways	8U	AAW
Astral Aviation	8V	ACP
Wizz Air Hungary	8Z	WVL
Ciao Air	99	\N
All Africa	9A	99F
China SSS	9C	\N
Pinnacle Airlines	9E	FLG
MDLR Airlines	9H	\N
Regionalia Chile	9J	CR1
Cape Air	9K	KAP
Colgan Air	9L	CJC
Regional Air Iceland	9N	N78
PB Air	9Q	PBA
SATENA	9R	NSE
Spring Airlines	9S	CQH
Transwest Air	9T	ABS
Air Moldova	9U	MLD
Jet Airways	9W	JAI
Regionalia Venezuela	9X	9XX
Air Kazakhstan	9Y	KZK
Atifly	A1	A1F
All America	A2	AL2
Aegean Airlines	A3	AEE
Southern Winds Airlines	A4	SWD
Airlinair	A5	RLA
Air Alps Aviation (A6)	A6	\N
Air Plus Comet	A7	MPD
Georgian Airways	A9	TGZ
American Airlines	AA	AAL
Air Berlin	AB	BER
Air Canada	AC	ACA
Azul	AD	AZU
Mandarin Airlines	AE	MDA
Air France	AF	AFR
Air Algerie	AH	DAH
Air India Limited	AI	AIC
Aero Contractors	AJ	NIG
AirAsia	AK	AXM
Skywalk Airlines	AL	SYX
AeroMéxico	AM	AMX
Ansett Australia	AN	AAA
Avianova (Russia)	AO	\N
Air One	AP	ADH
Aloha Airlines	AQ	AAH
Aerolineas Argentinas	AR	ARG
Alaska Airlines	AS	ASA
Royal Air Maroc	AT	RAM
Austral Lineas Aereas	AU	AUT
Avianca - Aerovias Nacionales de Colombia	AV	AVA
Asian Wings Airways	AW	AWM
Trans States Airlines	AX	LOF
Finnair	AY	FIN
Alitalia	AZ	AZA
Aws express	B0	666
Baltic Air lines	B1	BA1
Belavia Belarusian Airlines	B2	BRU
Bellview Airlines	B3	BLV
Flyglobespan	B4	GSM
Flightline	B5	FLT
JetBlue Airways	B6	JBU
Uni Air	B7	UIA
Eritrean Airlines	B8	ERT
Air Bangladesh	B9	BGD
British Airways	BA	BAW
Seaborne Airlines	BB	SBS
Skymark Airlines	BC	SKY
bmi	BD	BMA
Flybe	BE	BEE
Aero-Service	BF	RSR
Biman Bangladesh Airlines	BG	BBC
Hawkair	BH	
Royal Brunei Airlines	BI	RBA
Nouvel Air Tunisie	BJ	LBT
Potomac Air	BK	PDC
Jetstar Pacific	BL	PIC
Air Sicilia	BM	
Horizon Airlines	BN	HZA
Air Botswana	BP	BOT
Buquebus Líneas Aéreas	BQ	BQB
EVA Air	BR	EVA
British International Helicopters	BS	BIH
Air Baltic	BT	BTI
Baikotovitchestrian Airlines 	BU	BUU
Blue Panorama Airlines	BV	BPA
Caribbean Airlines	BW	BWA
Air Busan	BX	ABL
Thomsonfly	BY	TOM
Black Stallion Airways	BZ	BSA
Centralwings	C0	CLW
CanXpress	C1	CA1
CanXplorer	C2	CAP
Contact Air	C3	KIS
QatXpress	C3	QAX
LionXpress	C4	LIX
CommutAir	C5	UCA
Sky Wing Pacific	C7	CR7
Cirrus Airlines	C9	RUS
Air China Cargo	CA	CAO
Air China	CA	CCA
CCML Airlines	CB	CCC
Air Atlanta Icelandic	CC	ABD
Macair Airlines	CC	MCK
Nationwide Airlines	CE	NTW
City Airline	CF	SDR
Airlines PNG	CG	TOK
Bemidji Airlines	CH	BMJ
China Airlines	CI	CAL
China Airlines Cargo	CI	CAL
BA CityFlyer	CJ	CFE
Lufthansa CityLine	CL	CLH
Copa Airlines	CM	CMP
Canadian National Airways	CN	YCP
Continental Airlines	CO	COA
Continental Express	CO	
Canadian Airlines	CP	CDN
Compass Airlines	CP	CPZ
SOCHI AIR	CQ	KOL
Continental Micronesia	CS	CMI
Alitalia Cityliner	CT	\N
Cubana de Aviación	CU	CUB
Air Chathams	CV	CVA
Air Marshall Islands	CW	CWM
Cathay Pacific	CX	CPA
Cathay Pacific Cargo	CX	CPA
Cyprus Airways	CY	CYP
China Southern Airlines	CZ	CSN
DHL Air UK	D0	DHK
Domenican Airlines	D1	MDO
Daallo Airlines	D3	DAO
Interair South Africa	D6	ILN
AirAsia X	D7	XAX
Djibouti Airlines	D8	DJB
Aeroflot-Don	D9	DNV
Dana Air	DA	\N
Brit Air	DB	BZH
Golden Air	DC	GAO
Nok Air	DD	NOK
Condor Flugdienst	DE	CFG
Michael Airlines	DF	MJG
South East Asian Airlines	DG	SRQ
Dennis Sky	DH	DSY
dba	DI	BAG
Eastland Air	DK	ELA
Delta Air Lines	DL	DAL
Maersk	DM	
Senegal Airlines	DN	SGG
Dominicana de Aviaci	DO	DOA
First Choice Airways	DP	FCA
Coastal Air	DQ	
Air Mediterranee	DR	BIE
EasyJet (DS)	DS	\N
TAAG Angola Airlines	DT	DTA
Scat Air	DV	VSV
DAT Danish Air Transport	DX	DTR
Norwegian Air Shuttle	DY	NAX
Starline.kz	DZ	\N
Usa Sky Cargo	E1	ES2
Domodedovo Airlines	E3	DMO
Elysian Airlines	E4	GIE
Air Arabia Egypt	E5	RBG
Compagnie Africaine d\\'Aviation	E9	\N
European Air Express	EA	EAL
Avialeasing Aviation Company	EC	TWN
Airblue	ED	ABQ
Far Eastern Air Transport	EF	EFA
Japan Asia Airways	EG	JAA
Aer Lingus	EI	EIN
New England Airlines	EJ	NEA
Emirates	EK	UAE
Emirates SkyCargo	EK	UAE
Air Nippon	EL	ANK
Aero Benin	EM	AEB
Air Dolomiti	EN	DLA
Express One International	EO	LHN
Iran Aseman Airlines	EP	IRC
TAME	EQ	TAE
Fly Europa	ER	RWW
EuropeSky	ES	EUV
Ethiopian Airlines	ET	ETH
Empresa Ecuatoriana De Aviacion	EU	EEA
Atlantic Southeast Airlines	EV	ASQ
Eurowings	EW	EWG
Etihad Airways	EY	ETD
Evergreen International Airlines	EZ	EIA
Fly Brasil	F1	FBL
Flybaboo	F7	BBO
Air2there	F8	\N
Frontier Airlines	F9	FFT
Epic Holiday	FA	4AA
Bulgaria Air	FB	LZB
Finncomm Airlines	FC	WBA
Thai AirAsia	FD	AIQ
Ariana Afghan Airlines	FG	AFG
FlyHigh Airlines Ireland (FH)	FH	FHI
Icelandair	FI	ICE
Air Pacific	FJ	FJI
Africa West	FK	WTA
AirTran Airways	FL	TRS
Shanghai Airlines	FM	CSH
Regional Airlines	FN	
Airlines Of Tasmania	FO	ATM
Freedom Air	FP	FRE
Thomas Cook Airlines	FQ	TCW
Ryanair	FR	RYR
Servicios de Transportes A	FS	STU
Siem Reap Airways	FT	SRH
Felix Airways	FU	FXX
Rossiya-Russian Airlines	FV	SDM
Ibex Airlines	FW	IBX
FedEx Express	FX	FDX
Firefly	FY	FFM
Fly Dubai	FZ	FDB
Ghana International Airlines	G0	GHB
Indya Airline Group	G1	IG1
City Connexion Airlines	G3	CIX
Gol Transportes Aéreos	G3	GLO
Sky Express	G3	SEH
Allegiant Air	G4	AAY
Huaxia	G5	\N
Air Volga	G6	\N
GoJet Airlines	G7	GJS
Go Air	G8	GOW
Air Arabia	G9	ABY
Garuda Indonesia	GA	GIA
BRAZIL AIR	GB	BZE
TransAsia Airways	GE	TNA
Gulf Air Bahrain	GF	GBA
Air Guyane	GG	GUY
Globus	GH	GLP
Itek Air	GI	IKA
Eurofly Service	GJ	EEU
Genesis	GK	\N
Air Greenland	GL	GRL
German International Air Lines	GM	GER
GNB Linhas Aereas	GN	\N
Kuzu Airlines Cargo	GO	KZU
Gadair European Airlines	GP	GDR
Aurigny Air Services	GR	AUR
Air Foyle	GS	UPA
GB Airways	GT	GBL
Aero Flight	GV	ARF
Kuban Airlines	GW	KIL
Gabon Airlines	GY	GBK
Air Rarotonga	GZ	RAR
Hankook Air US	H1	HA1
Sky Airline	H2	SKU
Harbour Air (Priv)	H3	\N
I-Fly	H5	RSY
Hageland Aviation Services	H6	HAG
Eagle Air	H7	
Dalavia	H8	KHB
PEGASUS AIRLINES-	H9	\N
Hawaiian Airlines	HA	HAL
Himalayan Airlines	HC	HYM
Hokkaido International Airlines	HD	ADO
Luftfahrtgesellschaft Walter	HE	LGW
Hapagfly	HF	HLF
Niki	HG	NLY
Air Hamburg (AHO)	HH	AHO
Papillon Grand Canyon Helicopters	HI	\N
Yangon Airways	HK	\N
Air Seychelles	HM	SEY
Hankook Airline	HN	HNX
Juneyao Airlines	HO	DKH
America West Airlines	HP	AWE
China United Airlines	HR	CUA
Hellenic Imperial Airways	HT	IMP
Hainan Airlines	HU	CHH
Transavia Holland	HV	TRA
Hello	HW	FHE
Hong Kong Airlines	HX	CRK
Uzbekistan Airways	HY	UZB
Sat Airlines	HZ	SOZ
Iberia Express	I2	IBS
Indonesia Sky	I5	IDS
MexicanaLink	I6	MXI
Paramount Airways	I7	PMW
IzAvia	I8	\N
Air Italy	I9	AEY
Indigo	I9	IBU
Iraqi Airways	IA	IAW
Iberia Airlines	IB	IBE
Indian Airlines	IC	IAC
Interlink Airlines	ID	ITK
Solomon Airlines	IE	SOL
Islas Airways	IF	ISW
Meridiana	IG	ISS
LSM International 	II	UWW
Imair Airlines	IK	ITX
MAT Macedonian Airlines	IN	MAK
Indonesian Airlines	IO	IAA
Island Spirit	IP	ISX
Augsburg Airways	IQ	AUB
Iran Air	IR	IRA
Iran Air Cargo	IR	IRA
Island Airlines	IS	
Kingfisher Airlines	IT	KFR
Wind Jet	IV	JET
Wings Air	IW	WON
Air India Express	IX	AXB
Yemenia	IY	IYE
Arkia Israel Airlines	IZ	AIZ
Azerbaijan Airlines	J2	AHY
Northwestern Air	J3	PLR
ALAK	J4	\N
Alaska Seaplane Service	J5	\N
Denim Air 	J7	\N
Berjaya Air	J8	BVT
Jazeera Airways	J9	JZR
Air Bosna	JA	BON
Helijet	JB	JBA
JAL Express	JC	JEX
Japan Air System	JD	JAS
Mango	JE	MNO
Jetairfly	JF	JAF
Fuji Dream Airlines	JH	\N
Midway Airlines	JI	MDW
TAM Brazilian Airlines	JJ	TAM
Spanair	JK	JKK
Japan Airlines	JL	JAL
Japan Airlines Domestic	JL	JAL
Air Jamaica	JM	AJM
Excel Airways	JN	XLA
JALways	JO	JAZ
Adria Airways	JP	ADR
Jetstar Airways	JQ	JST
Joy Air	JR	JOY
Air Koryo	JS	KOR
Lion Mentari Airlines	JT	LNI
Jat Airways	JU	JAT
Bearskin Lake Air Service	JV	BLS
Arrow Air	JW	APW
Jusur airways	JX	JSR
Aereonautica militare	JY	AXZ
Skyways Express	JZ	SKX
Kostromskie avialinii	K1	KOQ
Eurolot	K2	ELO
SeaPort Airlines	K5	SQH
Cambodia Angkor Air (K6)	K6	\N
KoralBlue Airlines	K7	KBR
Zambia Skyways	K8	\N
Dragonair	KA	HDA
Druk Air	KB	DRK
Air Astana	KC	KZR
KD Avia	KD	KNI
Korean Air	KE	KAL
Korean Air Cargo	KE	KAL
Blue1	KF	BLF
Royal Airways	KG	RAW
Kharkiv Airlines	KH	KHK
Adam Air	KI	DHI
British Mediterranean Airways	KJ	LAJ
Atlasjet	KK	KKK
KLM Royal Dutch Airlines	KL	KLM
Air Malta	KM	AMC
China United	KN	\N
Alaska Central Express	KO	AER
Kenya Airways	KQ	KQA
Comores Airlines	KR	CWK
Peninsula Airways	KS	PEN
VickJet	KT	VKJ
Kuwait Airways	KU	KAC
Kavminvodyavia	KV	MVD
Carnival Air Lines	KW	\N
Cayman Airways	KX	CAY
KSY	KY	KSY
All Argentina	L1	AL1
LTU Austria	L3	LTO
Luchsh Airlines 	L4	LJJ
Lufttransport	L5	LTR
Mauritania Airlines International	L6	MAI
Lugansk Airlines	L7	\N
Line Blue	L8	LBL
All Asia	L9	AL3
LAN Airlines	LA	LAN
Air Costa	LB	\N
Varig Log	LC	VLO
FlyNordic	LF	NDC
Luxair	LG	LGL
Lufthansa	LH	DLH
Lufthansa Cargo	LH	GEC
Leeward Islands Air Transport	LI	LIA
Jin Air	LJ	JNA
Air Luxor	LK	LXR
Linhas A	LM	LAM
Libyan Arab Airlines	LN	LAA
LOT Polish Airlines	LO	LOT
LAN Peru	LP	LPE
LCM AIRLINES	LQ	LMM
LACSA	LR	LRC
Jet2.com	LS	EXS
LTU International	LT	LTU
LAN Express	LU	LXP
Albanian Airlines	LV	LBC
Pacific Wings	LW	NMI
El Al Israel Airlines	LY	ELY
Balkan Bulgarian Airlines	LZ	
Maryland Air	M1	M1F
MHS Aviation GmbH	M2	\N
ABSA - Aerolinhas Brasileiras	M3	TUS
Marysya Airlines	M4	1QA
Kenmore Air	M5	KEN
MasAir	M7	MAA
Motor Sich	M9	MSI
Malév	MA	MAH
MNG Airlines	MB	MNB
Air Madagascar	MD	MDG
Middle East Airlines	ME	MEA
Xiamen Airlines	MF	CXA
Malaysia Airlines	MH	MAS
MASkargo	MH	MAS
SilkAir	MI	SLK
L	MJ	LPR
Air Mauritius	MK	MAU
Maldivo Airlines	ML	MAV
Peach Aviation	MM	\N
Comair	MN	CAW
Abu Dhabi Amiri Flight	MO	AUH
Martinair	MP	MPH
American Eagle Airlines	MQ	EGF
Homer Air	MR	OME
Egyptair	MS	MSR
Thomas Cook Airlines	MT	TCX
China Eastern Airlines	MU	CES
Maya Island Air	MW	MYD
Mexicana de Aviaci	MX	MXA
Midwest Airlines (Egypt)	MY	MWA
Merpati Nusantara Airlines	MZ	MNA
Norte Lineas Aereas	N0	\N
N1	N1	\N
Regionalia México	N4	J88
Skagway Air Service	N5	SGY
All Spain	N7	N77
National Air Cargo	N8	NCR
All Europe	N9	N99
Al-Naser Airlines	NA	\N
Sterling Airlines	NB	SNB
National Jet Systems	NC	NJS
SkyEurope	NE	ESK
Air Vanuatu	NF	AVN
Lauda Air	NG	LDA
All Nippon Airways	NH	ANA
Portugalia	NI	PGA
Nordic Global Airlines	NJ	NGB
Spirit Airlines	NK	NKS
Shaheen Air International	NL	SAI
Air Madrid	NM	DRD
VIM Airlines	NN	MOV
Nile Air	NP	NIA
Air Japan	NQ	AJX
Jettor Airlines	NR	JTO
Nederlandse Spoorwegen	NS	\N
Binter Canarias	NT	IBB
Japan Transocean Air	NU	JTA
Northwest Airlines	NW	NWA
Air Macau	NX	AMU
Air Iceland	NY	FXI
Air New Zealand	NZ	ANZ
Orbit Airlines Azerbaijan	O1	OAB
Oceanic Airlines	O2	
Oceanair	O6	ONE
Ozjet Airlines	O7	OZJ
Oasis Hong Kong Airlines	O8	OHK
Olympic Airlines	OA	OAL
Astrakhan Airlines	OB	ASZ
Catovair	OC	\N
Malindo Air	OD	MXD
Air Finland	OF	FIF
AirOnix	OG	\N
Comair	OH	COM
Orchid Airlines	OI	ORC
Overland Airways	OJ	OLA
Czech Airlines	OK	CSA
Ostfriesische Lufttransport	OL	OLT
MIAT Mongolian Airlines	OM	MGL
Nauru Air Corporation	ON	RON
SkyWest	OO	SKW
Chongqing Airlines	OQ	CQN
TUI Airlines	OR	TFL
Austrian Airlines	OS	AUA
Aeropelican Air Services	OT	PEL
Croatia Airlines	OU	CTN
Estonian Air	OV	ELL
Orient Thai Airlines	OX	OEA
Omni Air International	OY	OAE
Asiana Airlines	OZ	AAR
Proflight Commuter Services	P0	
Patriot Airways	P4	\N
AeroRep	P5	RPB
Regional Paraguaya	P7	REP
Air Mekong	P8	MKG
Peruvian Airlines	P9	\N
Parmiss Airlines (IPV)	PA	IPV
Pegasus Airlines	PC	PGT
Porter Airlines	PD	POE
Air Europe	PE	AEL
Primera Air	PF	\N
Bangkok Airways	PG	BKP
Polynesian Airlines	PH	PAO
Piedmont Airlines (1948-1989)	PI	PDT
Air Saint Pierre	PJ	SPM
Pakistan International Airlines	PK	PIA
Aeroper	PL	PLI
Tropic Air	PM	TOS
West Air China	PN	CHB
FlyPortugal	PO	FPT
Air Indus	PP	AI0
LSM Airlines	PQ	LOO
Philippine Airlines	PR	PAL
Ukraine International Airlines	PS	AUI
Red Jet Andes	PT	\N
PLUNA	PU	PUA
PAN Air	PV	PNR
Precision Air	PW	PRF
Air Niugini	PX	ANG
Surinam Airways	PY	SLM
TAM Mercosur	PZ	LAP
Maldivian	Q2	\N
SOCHI AIR CHATER	Q3	QER
40-Mile Air	Q5	MLA
Aero Condor Peru	Q6	CDP
Pacific East Asia Cargo Airlines	Q8	PEC
Arik Niger	Q9	NAK
Click (Mexicana)	QA	\N
Georgian National Airlines	QB	GFG
Camair-co	QC	\N
Dobrolet	QD	DOB
Qantas	QF	QFA
Citilink Indonesia	QG	\N
Air Florida	QH	FLZ
Cimber Air	QI	CIM
Jet Airways	QJ	
Air Canada Jazz	QK	JZA
Aero Lanka	QL	RLN
Air Malawi	QM	AML
Origin Pacific Airways	QO	OGN
Alliance Airlines	QQ	UTY
Qatar Airways	QR	QTR
Qatar Airways Cargo	QR	QTR
Travel Service	QS	TVS
TAMPA	QT	TPA
East African	QU	UGX
Lao Airlines	QV	LAO
Blue Wings	QW	BWG
Horizon Air	QX	QXE
Red Jet Canada	QY	\N
Indonesia AirAsia	QZ	AWQ
Orenburg Airlines	R2	ORB
Aircompany Yakutia	R3	SYL
Rossiya	R4	
Malta Air Charter	R5	MAC
RACSA	R6	
Aserca Airlines	R7	OCA
AirRussia	R8	RRJ
Nepal Airlines	RA	RNA
Royal Nepal Airlines	RA	RNA
Syrian Arab Airlines	RB	SYR
Atlantic Airways	RC	FLI
Ryan International Airlines	RD	RYN
Aer Arann	RE	REA
Florida West International Airways	RF	FWL
VRG Linhas Aereas	RG	VRN
Republic Express Airlines	RH	RPH
Mandala Airlines	RI	MDL
Royal Jordanian	RJ	RJA
Air Afrique	RK	RKA
Royal Falcon	RL	RFJ
Rainbow Air US	RM	RNY
Rainbow Air (RAI)	RN	RAB
Tarom	RO	ROT
Chautauqua Airlines	RP	CHQ
Kam Air	RQ	KMF
Sky Regional	RS	\N
Rainbow Air Euro	RU	RUE
Caspian Airlines	RV	CPN
Republic Airlines	RW	RPA
Rainbow Air Polynesia	RX	RPO
Rainbow Air Canada	RY	RAY
Euro Exec Express	RZ	
Spike Airlines	S0	SAL
Serbian Airlines	S1	SA1
Air Sahara	S2	RSH
Santa Barbara Airlines	S3	BBR
SATA International	S4	RZO
Shuttle America	S5	TCF
Salmon Air	S6	\N
S7 Airlines	S7	SBI
Snowbird Airlines	S8	SBD
Starbow Airlines	S9	\N
South African Airways	SA	SAA
Air Caledonie International	SB	ACI
Shandong Airlines	SC	CDG
Sudan Airways	SD	SUD
XL Airways France	SE	SEU
Spicejet	SG	SEJ
Sharp Airlines	SH	SHA
Skynet Airlines	SI	SIH
Sriwijaya Air	SJ	SJY
Scandinavian Airlines System	SK	SAS
Thai Lion Air	SL	\N
Spirit of Manila Airlines	SM	MNP
Brussels Airlines	SN	DAT
Salsa d'Haiti	SO	SLC
SATA Air Acores	SP	SAT
Singapore Airlines	SQ	SIA
Singapore Airlines Cargo	SQ	SQC
Swissair	SR	SWR
Corsairfly	SS	CRL
Germania	ST	GMI
Aeroflot Russian Airlines	SU	AFL
Saudi Arabian Airlines	SV	SVA
Air Namibia	SW	NMB
SkyWork Airlines 	SX	\N
Sun Country Airlines	SY	SCX
Salzburg arrows	SZ	\N
TACA Peru	T0	\N
Thai Air Cargo	T2	TCG
Eastern Airways	T3	EZE
Hellas Jet	T4	HEJ
Turkmenistan Airlines	T5	TUA
Trans Pas Air	T6	TP6
Twin Jet	T7	TJT
Grupo TACA	TA	TAT
TrasBrasil	TB	TBZ
Air Tanzania	TC	ATC
Atlantis European Airways	TD	LUR
FlyLal	TE	LIL
Malmö Aviation	TF	SCW
Thai Airways International	TG	THA
TransBrasil Airlines	TH	THS
TransHolding	TI	THI
T.J. Air	TJ	TJA
Turkish Airlines	TK	THY
Turkish Airlines Cargo	TK	THY
Airnorth	TL	ANO
Trans Mediterranean Airlines	TL	TMA
Air Mozambique	TM	\N
Air Tahiti Nui	TN	THT
Transavia France	TO	TVF
TAP Portugal	TP	TAP
Texas Wings	TQ	TXW
Tiger Airways	TR	TGW
Air Transat	TS	TSC
Tiger Airways Australia	TT	TGW
Tunisair	TU	TAR
Virgin Express	TV	VEX
Tway Airlines	TW	TWB
Air Caraïbes	TX	FWI
Iberworld	TY	IWD
Scoot	TZ	SCO
Aviabus	U1	ABI
easyJet	U2	EZY
Avies	U3	AIA
PMTair	U4	PMT
USA3000 Airlines	U5	GWY
Ural Airlines	U6	SVR
Northern Dene Airways	U7	
Armavia	U8	RNV
Tatarstan Airlines	U9	TAK
United Airlines	UA	UAL
Myanma Airways	UB	UBA
LATAM Cargo Chile	UC	LCO
Hex'Air	UD	HER
Nasair	UE	NAS
UM Airlines	UF	UKM
Tuninter	UG	TUI
US Helicopter Corporation	UH	
Eurocypria Airlines	UI	ECA
AlMasria Universal Airlines	UJ	LMU
SriLankan Airlines	UL	ALK
Air Zimbabwe	UM	AZW
Transaero Airlines	UN	TSO
Hong Kong Express Airways	UO	HKE
Bahamasair	UP	BHS
Skyjet Airlines	UQ	SJU
UTair-Express	UR	\N
US Airways	US	USA
UTair Aviation	UT	UTA
Air Austral	UU	REU
Air Europa	UX	AEA
El-Buraq Air Transport	UZ	BRQ
Conviasa	V0	VCV
Vision Airlines (V2)	V2	RBY
Carpatair	V3	KRP
Danube Wings (V5)	V5	\N
VIP Ecuador	V6	\N
ATRAN Cargo Airlines	V8	VAS
Star1 Airlines	V9	HCW
Virgin Australia	VA	VOZ
Strategic Airlines	VC	\N
Air Libert	VD	
Volare Airlines	VE	VLE
Valuair	VF	VLU
VLM Airlines	VG	VLM
Virgin Pacific	VH	VNP
Volga-Dnepr Airlines	VI	VDA
Royal Air Cambodge	VJ	RAC
Virgin Nigeria Airways	VK	VGN
Air VIA	VL	VIM
Vietnam Airlines	VN	HVN
Tyrolean Airways	VO	TYR
VASP	VP	VSP
Viking Hellas	VQ	VKH
TACV	VR	TCV
Virgin Atlantic Airways	VS	VIR
Air Tahiti	VT	VTA
Air Ivoire	VU	VUN
Aerosvit Airlines	VV	AEW
Aeromar	VW	TAO
Virgin America	VX	VRD
Formosa Airlines	VY	FOS
Vueling Airlines	VY	VLG
MyTravel Airways	VZ	MYT
World Experience Airline	W1	WE1
Maastricht Airlines	W2	\N
AeroWorld 	W4	WER
Mahan Air	W5	IRM
Wizz Air	W6	WZZ
Austral Brasil	W7	\N
Air Bagan	W9	JAB
KLM Cityhopper	WA	KLC
Western Airlines	WA	WAL
Rwandair Express	WB	RWD
Islena De Inversiones	WC	ISV
Amsterdam Airlines	WD	AAN
Widerøe	WF	WIF
Sunwing	WG	\N
China Northwest Airlines (WH)	WH	\N
WebJet Linhas A	WJ	WEB
Edelweiss Air	WK	EDW
Windward Islands Airways	WM	\N
Southwest Airlines	WN	SWA
World Airways	WO	WOA
Island Air (WP)	WP	MKU
PanAm World Airways	WQ	PQW
WestJet	WS	WJA
Wizz Air Ukraine	WU	WAU
Swe Fly	WV	SWV
bmibaby	WW	BMI
CityJet	WX	BCY
Oman Air	WY	OMA
Red Wings	WZ	RWZ
TUIfly	X3	HLX
XAIR USA	XA	XAU
NEXT Brasil	XB	NXB
ExpressJet	XE	BTA
Vladivostok Air	XF	VLK
Calima Aviacion	XG	CLI
Mesaba Airlines	XJ	MES
Corse-Mediterranee	XK	CCM
Aerolane	XL	LNE
Alitalia Express	XM	SMX
Xpressair	XN	\N
LTE International Airways	XO	LTE
XPTO	XP	XPT
SunExpress	XQ	SXS
Skywest Australia	XR	\N
Air Exel	XT	AXL
BVI Airways	XV	\N
Sky Express	XW	SXR
Greenfly	XX	GFY
Nas Air	XY	KNE
Congo Express	XZ	\N
Yellowstone Club Private Shuttle	Y1	\N
Volaris	Y4	VOI
Asia Wings	Y5	AWA
NordStar Airlines	Y7	\N
Marusya Airways	Y8	MRS
Kish Air	Y9	IRK
Ciel Canadien	YC	YCC
Gomelavia	YD	\N
Yellowtail	YE	YEL
Yangon Airways Ltd.	YH	\N
Cyprus Turkish Airlines	YK	
Yamal Airlines	YL	LLM
Montenegro Airlines	YM	MGX
TransHolding System	YO	TYS
Polet Airlines (Priv)	YQ	\N
SENIC AIRLINES	YR	\N
Régional	YS	RAE
Yeti Airways	YT	\N
Mesa Airlines	YV	ASH
Air Nostrum	YW	ANE
Midwest Airlines	YX	MEP
Virginwings	YY	VWA
LSM AIRLINES 	YZ	YZZ
Zest Air	Z2	\N
Avient Aviation	Z3	SMJ
Zoom Airlines	Z4	OOM
ZABAIKAL AIRLINES	Z6	ZTT
REDjet	Z7	\N
Amaszonas	Z8	AZN
Flightlink Tanzania	Z9	\N
Access Air	ZA	CYD
Interavia Airlines	ZA	SUW
Air Bourbon	ZB	BUB
Monarch Airlines	ZB	MON
Korongo Airlines	ZC	KGO
Eastar Jet	ZE	ESR
Athens Airways	ZF	\N
Viva Macau	ZG	VVM
Shenzhen Airlines	ZH	CSZ
Aigle Azur	ZI	AAF
Zambezi Airlines (ZMA)	ZJ	\N
Great Lakes Airlines	ZK	GLA
Regional Express	ZL	RXA
Apache Air	ZM	IWA
Zenith International Airline	ZN	ZNA
Zabaykalskii Airlines	ZP	ZZZ
Locair	ZQ	LOC
Sama Airlines	ZS	SMY
Air Wisconsin	ZW	AWI
Japan Regio	ZX	ZXY
Ada Air	ZY	ADE
Zz	ZZ	\N
KMV	??	\N
Polar Airlines	??	\N
ConneX European Airline		2CO
Aerolineas Africanas		AA1
Copterline		AAQ
ACES Colombia		AES
Aviogenex		AGX
United States Air Force		AIO
Airlift International		AIR
Air Korea Co. Ltd.		AKA
Allegheny Commuter Airlines		ALO
ATA Airlines		AMT
AMC Airlines		AMV
Andalus Lineas Aereas		ANU
Indochina Airlines		AXC
Air Explore		AXE
Bluebird Airways (BZ)		BBG
Ocean Air		BCN
Bateleur Air		BEU
Bingo Airways		BGY
BF-Lento OY		BKF
Baltic Airlines		BLL
British Midland Regional		BMR
Budapest Aircraft Services/Manx2		BPS
Brazilian Air Force		BRS
Air Batumi		BTM
Air Bucharest		BUR
Corendon Airlines		CAI
Crest Aviation		CAN
CARICOM AIRWAYS (BARBADOS) INC.		CCB
Central Connect Airlines		CCG
CEIBA Intercontinental		CEL
Comfort Express Virtual Charters		CEO
Air Century		CEY
Click Airways		CGK
Charter Air		CHW
Canaryfly		CNF
SAS Braathens		CNO
Comtel Air		COE
Crown Airways		CRO
Air Cudlua		CUD
Dubrovnik Air		DBK
Air 26		DCD
Delta Aerotaxi		DEA
Royal Flight		DME
Dutch Antilles Express		DNL
Denim Air		DNM
Direct Aero Services		DSV
Eastok Avia		EAA
Ecuavia		ECU
EasyFly		EFY
BBN-Airways		EGH
Eagles Airlines		EGS
East Horizon		EHN
Small Planet Airlines		ELC
Enerjet		ENJ
Envoy Air		ENY
Air Italy Egypt		EUD
Comfort Express Virtual Charters Albany		EVC
Eznis Airways		EZA
Flybe Finland Oy		FCM
Feeder Airlines		FDD
Airfix Aviation		FIX
Flying kangaroo Airline		FKA
German Air Force - FLB		FLB
Finlandian		FN1
Norlandair		FNA
Freedom Airlines		FRL
Flugfelag Vestmannaeyja		FVM
Flyhy Cargo Airlines		FYH
FLYJET		FYJ
Grand Cru Airlines		GCA
Tianjin Airlines		GCR
Grand China Air		GDC
Gulf Air		GFA
Gulfstream International Airlines		GFT
Golden Myanmar Airlines		GMR
Georgian International Airlines		GNN
Hamburg Airways		HAY
Hebei Airlines		HBH
Holidays Czech Airlines		HCC
North American Charters		HMR
Happy Air		HPY
Hermes Airlines		HRM
Sky Europe Airlines		HSK
Helitt Líneas Aéreas		HTH
Turkish Air Force		HVK
Highland Airways		HWY
AIR INDOCHINE		IIA
OCEAN AIR CARGO		IXO
Jetflite		JEF
Jagson Airlines		JGN
Jupiter Airlines		JPU
Jc royal.britannica		JRB
Air KBZ		KBZ
Skyline Ulasim Ticaret A.S.		KCU
Kendell Airlines		KDA
Korea Express Air		KEA
Kinloss Flying Training Unit		KIN
Kal Star Aviation		KLS
Kan Air		KND
Russkie Krylya		KRY
Kosmos		KSM
Sunrise Airways		KSZ
Wataniya Airways		KW1
AlbaStar		LAV
Air Alfa		LFA
FlyLAL Charters		LLC
LatCharter		LTC
Morningstar Air Express		MAL
MCA Airlines		MCA
Medallion Air		MDP
Mint Airways		MIC
Air Majoro		MJP
EgyptAir Express		MSE
Mauritania Airways		MTW
Malaysia Wings		MWI
Myflug		MYA
Norfolk County Flight College		NCF
Transportes Aereos Cielos Andinos		NDN
Nesma Airlines		NMA
North American Airlines		NTM
Nihon.jet connect		NX1
Yeti Airlines 		NYT
Orbit International Airlines		OAI
Orbit Atlantic Airways		OAN
Orbit Regional Airlines		OAR
Orbest		OBS
Orbit Airlines		OBT
Sol Lineas Aereas		OLS
One Two Go Airlines		OTG
Skywest Airlines		OZW
Pacific Flier		PFL
Polet		POT
Royal Phnom Penh Airways		PPW
Pacific Island Aviation		PSA
Syrian Pearl Airlines		PSB
Passaredo Transportes Aereos		PTB
Privatair		PTI
Zapolyarie Airlines		PZY
Fars Air Qeshm		QFZ
ENTERair		QQQ
Icar Air		RAC
Rotana Jet		RJD
Rusline		RLU
Go2Sky		RLX
Simrik Airlines		RMK
Russia State Transport		RSD
Air Sunshine		RSI
RusJet		RSJ
Aeronorte		RTE
Ryan Air Services		RYA
ScotAirways		SAY
Scenic Airlines		SCE
Malmo Aviation		SCW
Southeast Air		SEA
Sevenair		SEN
Sahara Airlines		SHD
Carpatair Flight Training		SMW
Southern Air Charter		SOA
Southern Airways		SOU
South Pacific Island Airways		SPI
Solar Air		SRB
Sprintair		SRN
SVG Air		SVG
Swiss European Air Lines		SWU
Aerolineas heredas santa maria		SZB
SUR Lineas Aereas		SZZ
Air Moorea		TAH
Zanair		TAN
Transavia Denmark		TDK
Norwegian Aviation College		TFN
Trigana Air Service		TGN
Turk Hava Kurumu Hava Taksi Isletmesi		THK
Tajikistan International Airlines		TIL
Tomsk-Avia		TKS
Translift Airways		TLA
Transilvania		TNS
Turkuaz Airlines		TRK
Transair		TTZ
ATUR		TUR
Turkish Wings Domestic		TWD
United Air Charters		UAC
Ukraine Atlantic		UAT
Dniproavia		UDN
Yuzhmashavia		UMK
US Helicopter		USH
Vasco Air		VFC
Vision Air International		VIS
VietJet Air		VJC
Volotea		VOO
Flyme (VP)		VQI
AD Aviation		VUE
AirAsia Japan		WAJ
Westfalia Express VA		WFX
Air Southwest		WOW
Wind Rose Aviation		WRC
Whitejets		WTJ
CBM America		XBM
Excel Charter		XEL
XOJET		XOJ
Executive AirShare		XSR
YES Airways		YEP
